NO ./xpm/grass.xpm
SO ./xpm/rock.xpm
WE ./xpm/player.xpm
EA ./xpm/item.xpm

F 220,100,0
C 225,30,0

11111111111111
10000000000001
10000000000001
10000000000001
10000000000001
10000000000001
100000S0000001
10000000000001
10000010000001
10000000000001
10000000000001
10000000000001
10000000000001
11111111111111
